fecha	date	descripcion	entradas	SaldoAnotado	SaldoCalculado	persona	confirmado	concepto	entra	sale
04/1990	15-04-1990	Saldo Inicial (Entrega R.N.)	48000	48000	48000	Rosendo Naseiro		Efectivo	48000	
04/1990	15-04-1990	Entrega J. M.	-1530		46470	J.M.		Efectivo		1530
05/1990	15-05-1990	Entrega J. M.	-1530		44940	J.M.		Efectivo		1530
06/1990	15-06-1990	Entrega Paco (decl. Rent.)	-3000		41940	Francisco Álvarez Cascos		Efectivo		3000
06/1990	15-06-1990	Entrega J. M.	-1530		40410	J.M.		Efectivo		1530
07/1990	15-07-1990	Entrega J. M.	-1530		38880	J.M.		Efectivo		1530
07/1990	15-07-1990	Entrega J. M.	-1530		37350	J.M.		Efectivo		1530
08/1990	15-08-1990	Entrega J. M.	-1530		35820	J.M.		Efectivo		1530
09/1990	15-09-1990	Cobo	-12000		23820	Manuel Cobo del Rosal		Efectivo		12000
09/1990	15-09-1990	Cobo	-12000		11820	Manuel Cobo del Rosal		Efectivo		12000
11/1990	15-11-1990	Pepe C. (Gal.)	60000	71820	71820	Pepe Cuiña		Talón	60000	
11/1990	15-11-1990	Piñeiro	30000	101820	101820	Angel Piñeiro		Efectivo	30000	
11/1990	15-11-1990	Cobo	-12000		89820	Manuel Cobo del Rosal		Efectivo		12000
11/1990	15-11-1990	Cobo	-12000		77820	Manuel Cobo del Rosal		Efectivo		12000
11/1990	15-11-1990	Pedro A.	-30000		47820	Pedro Arriola		Efectivo		30000
12/1990	15-12-1990	Entrega Pedro A.	-36000		11820	Pedro Arriola		Efectivo		36000
12/1990	15-12-1990	Paco	90000	101820	101820	Paco		Efectivo	90000	
12/1990	15-12-1990	Rosen (abogado)	-12000		89820	Javier Boix		Efectivo		12000
01/1991	15-01-1991	Entrega Pedro A.	-45000		44820	Pedro Arriola		Efectivo		45000
02/1991	15-02-1991	Piñeiro	31440		76260	Angel Piñeiro		Efectivo	31440	
02/1991	15-02-1991	Piñeiro	54000		130260	Angel Piñeiro		Efectivo	54000	
03/1991	15-03-1991	Pago IVA Sdades	-2196		128064	Sociedades		Efectivo		2196
03/1991	15-03-1991	Pago Sdades	-3120		124944	Sociedades		Efectivo		3120
03/1991	15-03-1991	Pago IVA	-8640		116304	Sociedades		Efectivo		8640
03/1991	15-03-1991	Pago Sdades	-11712	104580	104592	Sociedades		Efectivo		11712
03/1991	15-03-1991	Diferencia IRPF (Paco)	-720		103872	Francisco Álvarez Cascos		Efectivo		720
03/1991	15-03-1991	Pago IVA y Sdades	-20040		83832	Sociedades		Efectivo		20040
03/1991	15-03-1991	Entrega a Rosen (abogado)	-30000		53832	Javier Boix		Efectivo		30000
03/1991	15-03-1991	Entrega a Pedro A. (enero/febrero)	-15000		38832	Pedro Arriola		Efectivo		15000
04/1991	15-04-1991	Piñeiro	36000	74820	74832	Angel Piñeiro		Efectivo	36000	
04/1991	15-04-1991	Entrega a Pedro A. (marzo/abril)	-15000		59832	Pedro Arriola		Efectivo		15000
05/1991	15-05-1991	Entrega a Rosen (liq. final)	-36000		23832	Javier Boix		Efectivo		36000
05/1991	15-05-1991	Piñeiro	42000		65832	Angel Piñeiro		Efectivo	42000	
06/1991	15-06-1991	Difer IRPF Paco decl. 90	-3000		62832	Francisco Álvarez Cascos		Efectivo		3000
06/1991	15-06-1991	Piñeiro	36000		98832	Angel Piñeiro		Efectivo	36000	
06/1991	15-06-1991	Entrega a Pedro A. (mayo/junio)	-15000		83832	Pedro Arriola		Efectivo		15000
07/1991	15-07-1991	Entrega "especial" a Pedro A. (encargo José M.)	-6000		77832	Pedro Arriola / Jose M.		Efectivo		6000
09/1991	15-09-1991	Registro Mercantil y acta notaría (Sdades)	-120		77712	Sociedades		Efectivo		120
09/1991	15-09-1991	Entrega a Pedro A. (julio/agosto)	-15000	62712	62712	Pedro Arriola		Efectivo		15000
09/1991	15-09-1991	Piñeiro	36000		98712	Angel Piñeiro		Efectivo	36000	
10/1991	15-10-1991	Entrega a Viñarás (Canarias, Cascos/Rajoy)	-1500		97212	Pedro Viñarás		Efectivo		1500
11/1991	15-11-1991	Entrega a Pedro A. (sept y oct)	-15000		82212	Pedro Arriola		Efectivo		15000
12/1991	15-12-1991	Entrega a Jaime I. del B.	-3600		78612	Jaime Ignacio del Burgo	confirmado	Efectivo		3600
12/1991	15-12-1991	Entrega a Pedro A. (nov y dic)	-15000		63612	Pedro Arriola		Efectivo		15000
12/1991	15-12-1991	Entrega a Javier A para Rafa A.	-6000		57612	Javier Arenas, Rafa A.		Efectivo		6000
01/1992	15-01-1992	Entrega Miguel A.R.	-1050		56562	Miguel Ángel Rodríguez, Isabel Tenaille		Efectivo		1050
02/1992	15-02-1992	Entrega Pedro A. (enero)	-7500		49062	Pedro Arriola		Efectivo		7500
02/1992	15-02-1992	Entrega a Javier A. para Rafa A.	-6000		43062	Javier Arenas, Rafa A.		Efectivo		6000
03/1992	15-03-1992	Entrega A. Cámara para Laureano	-9600		29862	Laureano López Rodó		Efectivo		9600
03/1992	15-03-1992	Entrega Pedro A. (febrero)	-7500		22362	Pedro Arriola		Efectivo		7500
?	15-05-1992		0	9396	22362			Saldo		
05/1992	15-05-1992	Piñeiro	60000		82362	Angel Piñeiro		Efectivo	60000	
05/1992	15-05-1992	Entrega a Jaime I. (Calixto)	-3600		78762	Jaime Ignacio del Burgo, Calixto Yesa	confirmado	Efectivo		3600
05/1992	15-05-1992	Entrega a Cámara para Laureano	-7200		71562	Laureano López Rodó		Efectivo		7200
05/1992	15-05-1992	Entrega a Pedro A. (abril)	-7500		64062	Pedro Arriola		Efectivo		7500
05/1992	15-05-1992	Notaría Liq Ibé de F.	-1200		62862	Sociedad Ibérica de Firmes		Efectivo		1200
05/1992	15-06-1992	Entrega Pedro A. (regulariz. desde 1º año)	-1788		61074	Pedro Arriola		Efectivo		1788
06/1992	15-06-1992	Entrega Pedro A. (mayo)	-7944		53130	Pedro Arriola		Efectivo		7944
06/1992	15-06-1992	Entrega a Samuel Para anuncios (2 sdads)	-18600		34530	Sociedades		Efectivo		18600
06/1992	15-06-1992	Entrega a J.I. Burgo	-3600		30930	Jaime Ignacio del Burgo	confirmado	Efectivo		3600
06/1992	15-06-1992	Entrega a Paco A. C. para declaración	-1800		29130	Francisco Álvarez Cascos		Efectivo		1800
06/1992	15-06-1992	Pag parte dictamen Cobo	-18000		11130	Manuel Cobo del Rosal		Efectivo		18000
06/1992	15-06-1992	Entrega a Ortí B. por indic. José Mª(canje)	-3000		8130	José Miguel Ortí Bordás		Efectivo		3000
06/1992	15-07-1992	Entrega a Paco para Begoña	-3900		4230	José María Peña		Efectivo		3900
07/1992	15-07-1992	Entrega a Pedro A. (junio)	-7944		-3714	Pedro Arriola		Efectivo		7944
07/1992	15-07-1992	Piñeiro	30000		26286	Angel Piñeiro		Efectivo	30000	
07/1992	15-07-1992	Pago ingreso 123 IRPF IB. de F.	-6186		20100	Sociedad Ibérica de Firmes		Efectivo		6186
07/1992	15-07-1992	Entrega a Paco para Begoña	-3900		16200	José María Peña		Efectivo		3900
07/1992	15-07-1992	Entrega a Pedro A. (julio)	-7944	10230	8256	Pedro Arriola		Efectivo		7944
07/1992	15-07-1992	Persona enviada por Piñeiro	240000		248256	Angel Piñeiro		Efectivo	240000	
07/1992	15-07-1992	Entrega a Paco para Begoña	-180000		68256	José María Peña		Efectivo		180000
09/1992	15-09-1992	Entrega a Pedro A. (agosto)	-7404		60852	Pedro Arriola		Efectivo		7404
09/1992	15-09-1992	Entrega a Jaime I. del B. (junio/julio/agosto)	-5400		51552	Jaime Ignacio del Burgo		Efectivo		5400
09/1992	15-09-1992	Entrega a Pedro A.("operac. adicional" sept/oct)	-12000		39552	Pedro Arriola		Efectivo		12000
09/1992	15-09-1992	Piñeiro	42000	82986	81552	Angel Piñeiro		Efectivo	42000	
10/1992	15-10-1992	Entrega a Pedro A. (septiembre)	0		81552			Efectivo		
10/1992	15-10-1992	Gto. Notar Liquid. 2 Sdads	-2400		79152	Pedro Arriola		Efectivo		2400
10/1992	15-10-1992	Entrega a Juan Carlos Aparicio Pérez (indic. Paco)	0		79152	Juan Carlos Aparicio Pérez		Efectivo		
10/1992	15-10-1992	Piñeiro	30000		109152	Angel Piñeiro		Efectivo	30000	
10/1992	15-10-1992	Entrega a Pedro A. (octubre)	-7944		101208	Pedro Arriola		Efectivo		7944
10/1992	15-11-1992	Entrega a J.I. del B. (sept/oct.)	-3600		97608	Jaime Ignacio del Burgo	confirmado	Efectivo		3600
10/1992	15-01-1993	Entrega a Pedro A. (noviembre)	-10704		79584	Pedro Arriola		Efectivo		10704
11/1992	15-01-1993	Entrega a Pedro A. (por trb. adic. de carácter. extraord.)	-6000		73584	Pedro Arriola		Efectivo		6000
11/1992	15-01-1993	Entrega a Pedro A. (trab adic. al cto 4º trim 91 y todo el 92)	-17604		55980	Pedro Arriola		Efectivo		17604
01/1993	15-01-1993	Entrega a Pedro A. (diciembre)	-7944		48036	Pedro Arriola		Efectivo		7944
01/1993	15-01-1993	Entrega a Rosen por indic. Paco (liquid. Ptes)	-18000	22386	30036	Francisco Álvarez Cascos		Efectivo		18000
01/1993	15-02-1993	Entrega a Rosen por indic. Paco (FINIQUITO)	-12000		18036	Francisco Álvarez Cascos		Efectivo		12000
01/1993	15-02-1993	Entrega a Pedro A. (por trab. adic. de carácter.extraord.)	-6000	4386	12036	Pedro Arriola		Efectivo		6000
01/1993	15-02-1993	Devolución Liquid Notarios	-210	4596	11826	Sociedades		Efectivo		210
02/1993	15-02-1993	Saldo anterior	0	4596						
02/1993	15-03-1993	Entrega a José M. Ortí (indic. Jose Mª)	-2100	2496	9726	José Miguel Ortí Bordás, José María Aznar				2100
02/1993	15-03-1993	1os 93 / Entrega Piñeiro	42000	44496	51726	Angel Piñeiro			42000	
02/1993	15-03-1993	Entrega a Jaime I. (Nov.-Dic.)	-3600	40896	48126	Jaime Ignacio del Burgo	confirmado			3600
02/1993	15-04-1993	A Pedro (especial)  (indic. Jose Mª)	-6000	34896	42126	Pedro Arriola				6000
03/1993	15-03-1993	Entrega a P.A. cta 1993 (En. y Febr.)	-19320	15576	22806	Pedro Arriola				19320
03/1993	15-04-1993	Entre a P.A     Trab. Extraord. (  En. y Febr. )	-12000	3576	10806	Pedro Arriola				12000
03/1993	15-04-1993	Entrega a Jose Mª Robles (severo moto)	-3000	576	7806	Severo Moto				3000
04/1993	15-04-1993	Entrega Piñeiro	90000	90576	97806	Angel Piñeiro			90000	
03/1993	15-05-1993	Entrega a Jaime I. (Ene.-Febr.)	-3600	86976	94206	Jaime Ignacio del Burgo	confirmado			3600
04/1993	15-05-1993	Entrega a Jose M. Orti	-2100	84876	92106	José Miguel Ortí Bordás				2100
04/1993	15-05-1993	P. Arr. (Marzo)	-9660	75216	82446	Pedro Arriola				9660
04/1993	15-06-1993	P. Arr. Trab. extraord.(Marzo)	-6000	69216	76446	Pedro Arriola				6000
05/1993	15-05-1993	Entrega a Jaime I. (Marzo-Abril)	-3600	65616	72846	Jaime Ignacio del Burgo	confirmado			3600
05/1993	15-06-1993	P. Arr. (Abril)	-9660	55956	63186	Pedro Arriola				9660
05/1993	15-07-1993	P. Arr. por Trab. extraord. (Abril)	-6000	49956	57186	Pedro Arriola				6000
06/1993	15-07-1993	P. Arr. (Mayo)	-9660	40296	47526	Pedro Arriola				9660
05/1993	15-07-1993	Entrega Piñeiro	60000	100296	107526	Angel Piñeiro			60000	
06/1993	15-07-1993	Entrega a P.A.C para Renta 92	-3600	96696	103926	Francisco Álvarez Cascos				3600
07/1993	15-07-1993	Entrega a Jaime I. (Mayo-Junio)	-3600	93096	100326	Jaime Ignacio del Burgo	confirmado			3600
07/1993	15-07-1993	P. Arr. (trab. extr. (Mayo)	-6000	87096	94326	Pedro Arriola				6000
07/1993	15-07-1993	P. Arr. (Junio)	-9660	77436	84666	Pedro Arriola				9660
07/1993	15-07-1993	P. ( Arr (trab extr. Junio)	-6000	71436	88326	Pedro Arriola				6000
07/1993	15-07-1993	Jose Miguel O.	-2100	69336	82566	José Miguel Ortí Bordás				2100
07/1993	15-09-1993	Marz Abr Mayo y Jun Dieta Sº G (218652x4)	-5250	64086	77316	Francisco Álvarez Cascos				5250
07/1993	15-09-1993	P. Arr. (Julio)	-9660	54426	67656	Pedro Arriola				9660
07/1993	15-09-1993	Entrega a Jose Mª Robles (moto)	-1200	53226	66456	Severo Moto				1200
07/1993	15-09-1993	Dietas Sº Gral. (220.000 Julio)	-1320	51906	65136	Francisco Álvarez Cascos				1320
09/1993	15-09-1993	Dietas Sº Gral. (Agosto)	-1320	50586	63816	Francisco Álvarez Cascos				1320
09/1993	15-09-1993	Pedro Arr. (Agosto)	-9660	40926	54156	Pedro Arriola				9660
09/1993	15-09-1993	P. A. (trab. extr. Julio-Agosto)	-12000	28926	42156	Pedro Arriola				12000
09/1993	15-09-1993	Entrega a Jaime I. (Julio-Agosto)	-3600	25326	38556	Jaime Ignacio del Burgo	confirmado			3600
09/1993	15-10-1993	Dietas Sº Gral. (Sept.)	-1320	24006	37236	Francisco Álvarez Cascos				1320
09/1993	15-10-1993	Gratif. campaña Gral. Asesoría Sº Gral.	-1200	22806	36036	Francisco Álvarez Cascos				1200
09/1993	15-10-1993	Compensar Renta J.A.	-3600		32436	Javier Arenas				3600
09/1993	15-10-1993	Pago Hotel	-1932		30504	Hotel				1932
10/1993	15-11-1993	A Pedro (Trabajo. Ex. Sep.)	-6000		24504	Pedro Arriola				6000
10/1993	15-11-1993	Entrega Piñe.	60000		84504	Angel Piñeiro			60000	
10/1993	15-11-1993	A Pedro (Septiembre)	-9660		74844	Pedro Arriola				9660
10/1993	15-11-1993	A P.A.C dietas octubre	-1320		73524	Francisco Álvarez Cascos				1320
11/1993	15-11-1993	A Pedro, trabajos extra.	-6000		67524	Pedro Arriola				6000
11/1993	15-11-1993	A Pedro (Octubre)	-9660		57864	Pedro Arriola				9660
11/1993	15-12-1993	A P.A.C. dietas noviemb	-1320		56544	Francisco Álvarez Cascos				1320
11/1993	15-12-1993	A Jaime I. (sept. y octub)	-3600		52944	Jaime Ignacio del Burgo	confirmado			3600
11/1993	15-12-1993	A Jose M. Orti	-2100		50844	José Miguel Ortí Bordás				2100
11/1993	15-12-1993	Sanchez	-1800		49044	Sanchez				1800
12/1993	15-12-1993	Entrega Piñe.	30000		79044	Angel Piñeiro			30000	
12/1993	15-12-1993	Entrega Piñe.	42000		121044	Angel Piñeiro			42000	
12/1993	15-12-1993	A Pedro Trabajos extra	-6000		115044	Pedro Arriola				6000
12/1993	15-01-1994	A Pedro (Noviembre)	-9660		105384	Pedro Arriola				9660
12/1993	15-01-1994	A P.A.C dietas Diciembre	-1320		104064	Francisco Álvarez Cascos				1320
12/1993	15-01-1994	A Pedro Trab.ext.diciem	-6000		98064	Pedro Arriola				6000
12/1993	15-02-1994	A Pedro (Diciembre)	-9660		88404	Pedro Arriola				9660
01/1994	15-02-1994	Saldo anterior	0	75174	88404					
01/1994	15-02-1994	a jaime I.Nov.yDic.	-3600	71574	84804	Jaime Ignacio del Burgo	confirmado			3600
01/1994	15-02-1994	Billete secretario	-180	71394	84624	Secretario				180
02/1994	15-02-1994	Pedro trab.ext.enero	-6000	65394	78624	Pedro Arriola				6000
02/1994	15-03-1994	Pedro enero	-9660	55734	68964	Pedro Arriola				9660
02/1994	15-03-1994	Jose Miguel O.	-2100	53634	66864	José Miguel Ortí Bordás				2100
02/1994	15-03-1994	P.A.C. Enero	-1320	52314	65544	Francisco Álvarez Cascos				1320
02/1994	15-03-1994	P.A.C. Febrero	-1320	50994	64224	Francisco Álvarez Cascos				1320
03/1994	15-03-1994	a Jaime I.Ener y Febr.	-3600	47394	60624	Jaime Ignacio del Burgo	confirmado			3600
03/1994	15-03-1994	Atrasos Enero Pedro	-480	46914	60144	Pedro Arriola				480
03/1994	15-03-1994	Pedro trab.ext.febrero	-6000	40914	54144	Pedro Arriola				6000
03/1994	15-04-1994	Pedro Febrero	-10140	30774	44004	Pedro Arriola				10140
03/1994	15-04-1994	Pedro trab.ext.marzo	-6000	24774	38004	Pedro Arriola				6000
03/1994	15-04-1994	Pedro Marzo	-10140	14634	27864	Pedro Arriola				10140
03/1994	15-05-1994	P.A.C. Marzo	-1320	13314	26544	Francisco Álvarez Cascos				1320
04/1994	15-05-1994	P.A.C. Abril	-1320	11994	25224	Francisco Álvarez Cascos				1320
04/1994	15-05-1994	Pedro trab.ext. abril	-6000	5994	19224	Pedro Arriola				6000
04/1994	15-05-1994	Entrega F.A.C.	60000	65994	79224	Francisco Álvarez Cascos			60000	
05/1994	15-05-1994	P.A.C. Mayo	-1320	64674	77904	Francisco Álvarez Cascos				1320
05/1994	15-05-1994	Entrega a Jose M.Ort.	-2100	62574	75804	José Miguel Ortí Bordás				2100
05/1994	15-05-1994	Pedro Abril	-10140	52434	65664	Pedro Arriola				10140
05/1994	15-06-1994	A Jaime ign. (Mar.Abril)	-3600	48834	62064	Jaime Ignacio del Burgo	confirmado			3600
05/1994	15-07-1994	Sanchez	-2400	46434	59664	Sanchez				2400
05/1994	15-07-1994	Pedro trab.extr.mayo	-6000	40434	53664	Pedro Arriola				6000
05/1994	15-07-1994	Pedro Mayo	-10140	30294	43524	Pedro Arriola				10140
06/1994	15-06-1994	Javier compens.rent93	-4200	26094	39324	Javier Arenas				4200
07/1994	15-07-1994	Paco compens.rent.93	-3600	22494	35724	Francisco Álvarez Cascos				3600
07/1994	15-07-1994	Pedro trab.ext. Junio	-6000	16494	29724	Pedro Arriola				6000
07/1994	15-07-1994	Pedro Junio	-10140	6354	19584	Pedro Arriola				10140
06/1994	15-06-1994	P.A.C. Junio	-1320	5034	18264	Francisco Álvarez Cascos				1320
07/1994	15-07-1994	A Jaime ign. (Mayo Jun)	-3600	1434	14664	Jaime Ignacio del Burgo	confirmado			3600
07/1994	15-07-1994	Entrega Ramón	42000	43434	56664	Ramón			42000	
07/1994	15-07-1994	Pedro trab.ex.julio	-6000	37434	50664	Pedro Arriola				6000
07/1994	15-07-1994	Pedro Julio	-10140	27294	40524	Pedro Arriola				10140
07/1994	15-07-1994	PAC Julio	-1320	25974	39204	Francisco Álvarez Cascos				1320
08/1994	15-08-1994	PAC Agosto	-1320	24654	37884	Francisco Álvarez Cascos				1320
09/1994	15-09-1994	Pedro Trab.ex.agosto	-6000	18654	31884	Pedro Arriola				6000
09/1994	15-09-1994	Pedro Agosto	-10140	8514	21744	Pedro Arriola				10140
09/1994	15-09-1994	Jose Miguel Orti	-1800	6714	19944	José Miguel Ortí Bordás				1800
09/1994	15-09-1994	Jaime Ign. (jul y Agosto)	-3600	3114	16344	Jaime Ignacio del Burgo	confirmado			3600
09/1994	15-09-1994	PAC Septiembre	-1320	1794	15024	Francisco Álvarez Cascos				1320
09/1994	15-09-1994	Parte Pedro Septiem.	-240	1554	14784	Pedro Arriola				240
10/1994	15-10-1994	Entrega Piñeiro	90000	91554	104784	Angel Piñeiro			90000	
10/1994	15-10-1994	PAC Octubre	-1320	90234	103464	Francisco Álvarez Cascos				1320
11/1994	15-11-1994	Jaime Ign. (Sep. y Oct.)	-3600	86634	99864	Jaime Ignacio del Burgo	confirmado			3600
11/1994	15-11-1994	Pedro Octubre	-10140	76494	89724	Pedro Arriola				10140
11/1994	15-11-1994	Pedro Trab.ex.Octubre	-6000	70494	83724	Pedro Arriola				6000
11/1994	15-11-1994	PAC Noviembre	-1320	69174	82404	Francisco Álvarez Cascos				1320
12/1994	15-12-1994	J.A. Sanchez	-2400	66774	80004	José Antonio Sánchez				2400
01/1995	15-01-1995	Saldo anterior	0	27354	80004					
01/1995	15-01-1995	Entrega a Salvador	-12900	14454	67104	Salvador Palop				12900
01/1995	15-01-1995	PAC Enero	-1368	13086	65736	Francisco Álvarez Cascos				1368
02/1995	15-02-1995	Entrega Angel P.	90000	103086	155736	Angel Piñeiro			90000	
02/1995	15-02-1995	Pedro enero	-6000	97086	149736	Pedro Arriola				6000
02/1995	15-02-1995	Pedro enero	-10590	86496	139146	Pedro Arriola				10590
03/1995	15-03-1995	Pedro Febrero	-6000	80496	133146	Pedro Arriola				6000
03/1995	15-03-1995	Pedro Febrero	-10590	69906	122556	Pedro Arriola				10590
03/1995	15-03-1995	PAC Febrero	-1368	68538	121188	Francisco Álvarez Cascos				1368
03/1995	15-03-1995	Jaime I.(enero y febrer.)	-3600	64938	117588	Jaime Ignacio del Burgo	confirmado			3600
03/1995	15-03-1995	Recargo Iv.Ib. de fir	-1068	63870	116520	Sociedad Ibérica de Firmes				1068
03/1995	15-03-1995	PAC Marzo	-1368	62502	115152	Francisco Álvarez Cascos				1368
04/1995	15-04-1995	Entrega a J.M.Orti	-1800	60702	113352	José Miguel Ortí Bordás				1800
04/1995	15-04-1995	Pedro Marzo	-6000	54702	107352	Pedro Arriola				6000
04/1995	15-04-1995	Pedro Marzo	-10590	44112	96762	Pedro Arriola				10590
04/1995	15-04-1995	Entrega Angel P-	30000	74112	126762	Angel Piñeiro			30000	
04/1995	15-04-1995	PAC Abril	-1368	72744	125394	Francisco Álvarez Cascos				1368
05/1995	15-05-1995	Jaime I.(Mar. y Abril)	-3600	69144	121794	Jaime Ignacio del Burgo	confirmado			3600
05/1995	15-05-1995	Entrega Angel Piñeiro	24000	93144	145794	Angel Piñeiro			24000	
05/1995	15-05-1995	Pedro Abril	-600	87144	145194	Pedro Arriola				600
05/1995	15-05-1995	Pedro Abril	-10590	76554	134604	Pedro Arriola				10590
05/1995	15-05-1995	Entrega Angel P.	48000	124554	182604	Angel Piñeiro			48000	
06/1995	15-06-1995	PAC Mayo	-1368	123186	181236	Francisco Álvarez Cascos				1368
06/1995	15-06-1995	Pedro Mayo	-6000	117186	175236	Pedro Arriola				6000
06/1995	15-06-1995	Pedro Mayo	-10590	106596	164646	Pedro Arriola				10590
06/1995	15-06-1995	Entrega Angel P.	24000	130596	188646	Angel Piñeiro			24000	
06/1995	15-06-1995	Jaime I (Mayo y Junio)	-3600	126996	185046	Jaime Ignacio del Burgo	confirmado			3600
07/1995	15-07-1995	Pedro Junio	-6000	120996	179046	Pedro Arriola				6000
07/1995	15-07-1995	Pedro Junio	-10590	110406	168456	Pedro Arriola				10590
07/1995	15-07-1995	PAC Junio	-1368	109038	167088	Francisco Álvarez Cascos				1368
07/1995	15-07-1995	Entrega J.M.Orti	-1800	107238	165288	José Miguel Ortí Bordás				1800
07/1995	15-07-1995	J.A. Sanchez (M.A. Rod)	-1800	105438	163488	José Antonio Sánchez				1800
07/1995	15-07-1995	PAC Julio	-1368	104070	162120	Francisco Álvarez Cascos				1368
07/1995	15-07-1995	Entrega PAC	24000	128070	186120	Francisco Álvarez Cascos			24000	
07/1995	15-07-1995	Pedro Julio	-6000	122070	180120	Pedro Arriola				6000
07/1995	15-07-1995	Pedro Julio	-10590	111480	169530	Pedro Arriola				10590
09/1995	15-09-1995	PAC Agosto	-1368	110112	168162	Francisco Álvarez Cascos				1368
09/1995	15-09-1995	Pedro Agosto	-6000	104112	162162	Pedro Arriola				6000
09/1995	15-09-1995	Pedro Agosto	-10590	93522	151572	Pedro Arriola				10590
09/1995	15-09-1995	Entrega J.M.Orti	-1800	91722	149772	José Miguel Ortí Bordás				1800
10/1995	15-10-1995	PAC Septiembre	-1368	90354	148404	Francisco Álvarez Cascos				1368
10/1995	15-10-1995	Pedro Septiembre	-6000	8435	142404	Pedro Arriola				6000
10/1995	15-10-1995	Pedro Septiembre	-10590	73764	131814	Pedro Arriola				10590
11/1995	15-11-1995	Pedro Octubre	-6000	67764	125814	Pedro Arriola				6000
11/1995	15-11-1995	Pedro Octubre	-10590	57174	115224	Pedro Arriola				10590
11/1995	15-11-1995	PAC Octubre	-1368	55806	113856	Francisco Álvarez Cascos				1368
11/1995	15-11-1995	Jaime I (Jul.Ag.Sep.fin)	-5400	50406	108456	Jaime Ignacio del Burgo	confirmado			5400
11/1995	15-11-1995	Entrega Angel P.	30000	80406	138456	Angel Piñeiro			30000	
12/1995	15-12-1995	PAC Noviembre	-1368	79038	137088	Francisco Álvarez Cascos				1368
01/1996	15-01-1996	saldo anterior	0	72690	137088					
01/1996	15-01-1996	PAC enero	-1416	71274	135672	Francisco Álvarez Cascos				1416
01/1996	15-01-1996	Pedro	-6000	65274	129672	Pedro Arriola				6000
01/1996	15-01-1996	Pedro	-1059	54684	128613	Pedro Arriola				1059
02/1996	15-02-1996	PAC febrero	-1416	53268	127197	Francisco Álvarez Cascos				1416
02/1996	15-02-1996	Pedro	-6000	47268	121197	Pedro Arriola				6000
02/1996	15-02-1996	Pedro	-10590	36678	110607	Pedro Arriola				10590
03/1996	15-03-1996	PAC marzo	-1416	35262	109191	Francisco Álvarez Cascos				1416
03/1996	15-03-1996	Pedro	-6000	29262	103191	Pedro Arriola				6000
03/1996	15-03-1996	Pedro	-10590	18672	92601	Pedro Arriola				10590
04/1996	15-04-1996	Pedro Abril	-1416	17256	91185	Pedro Arriola				1416
05/1996	15-05-1996	Entrega PAC	48000	65256	139185	Francisco Álvarez Cascos			48000	
05/1996	15-05-1996	Pedro Abril	-8100	57156	131085	Pedro Arriola				8100
05/1996	15-05-1996	Pedro Abril	-10590	46566	120495	Pedro Arriola				10590
06/1996	15-06-1996	Pedro Mayo	-8100	38466	112395	Pedro Arriola				8100
06/1996	15-06-1996	Pedro Mayo	-10590	27876	101805	Pedro Arriola				10590
06/1996	15-06-1996	PAC Mayo	-1416	26460	100389	Francisco Álvarez Cascos				1416
06/1996	15-06-1996	PAC junio	-1416	25044	98973	Francisco Álvarez Cascos				1416
07/1996	15-07-1996	Pedro Junio	-8100	16944	90873	Pedro Arriola				8100
07/1996	15-07-1996	Pedro Junio	-10590	6354	80283	Pedro Arriola				10590
09/1996	15-09-1996	PAC Julio	-1416	4938	78867	Francisco Álvarez Cascos				1416
09/1996	15-09-1996	PAC Agosto	-1416	3522	77451	Francisco Álvarez Cascos				1416
10/1996	15-10-1996	PAC Septiembre	-1416	2106	76035	Francisco Álvarez Cascos				1416
11/1996	15-11-1996	PAC Octubre	-1416	690	74619	Francisco Álvarez Cascos				1416
8/1/1997	08-01-1997	Galicia	30000		104619	Galicia			30000	
9/1/1997	09-01-1997	Are (Mayo/Dic.)	-19200	10800	85419	Javier Arenas				19200
24/01/1997	24-01-1997	Sant. L.	60000		145419	Sant. L.			60000	
29/01/1997	29-01-1997	R. (Mayo/Dic.)	-18000		127419	Rodrigo Rato				18000
24/02/1997	24-02-1997	P.A. (Mayo/Dic.)	-26400		101019	Francisco Álvarez Cascos				26400
24/02/1997	24-02-1997	M.R. (Mayo/Dic)	-16800		84219	Mariano Rajoy				16800
28/02/1997	28-02-1997	Galicia	11953		96172	Galicia			11953	
4/3/1997	04-03-1997	J.M. (Mayo/Dic.)	-16800		79372	Jaime Mayor Oreja				16800
24/04/1997	24-04-1997	Galicia (O.C.)	18000	22753	97372	Galicia			18000	
05/1997	15-05-1997	entrega PAC	60000	60690	157372	Francisco Álvarez Cascos			60000	
05/1997	15-05-1997	a Pedro a Cta.regulariz.	-60000	690	97372	Pedro Arriola				60000
5/5/1997	05-05-1997	R. (Enero / Junio 97)	-13680		83692	Rodrigo Rato				13680
8/7/1997	08-07-1997	López H.	90000		173692	Ignacio López del Hierro			90000	
8/7/1997	08-07-1997	Are (Enero/Junio 97)	-14400		159292	Javier Arenas				14400
9/7/1997	09-07-1997	P.A. (Enero/Junio 97)	-19800		139492	Francisco Álvarez Cascos				19800
15/07/1997	15-07-1997	M. R. (Enero / Junio 97)	-12600		126892	Mariano Rajoy				12600
21/07/1997	21-07-1997	J.M. (Enero / Junio 97)	-12600		114292	Jaime Mayor Oreja				12600
09/1997	15-09-1997	entrega PAC	60000	60690	174292	Francisco Álvarez Cascos			60000	
09/1997	15-09-1997	entrega Ramon	42000	102690	216292	Ramón			42000	
10/1997	15-10-1997	PAC de nov.96 a sep.97	-15900	86790	200392	Francisco Álvarez Cascos				15900
10/1997	15-10-1997	a Pedro a Cta.regulariz.	-60000	26790	140392	Pedro Arriola				60000
23/10/1997	23-10-1997	M.A.R.	-9000		131392	Miguel Ángel Rodríguez				9000
18/11/1997	18-11-1997	R. (Julio / Dic. 97)	-13680	16993	117712	Rodrigo Rato				13680
24/11/1997	24-11-1997	P.A. (Julio / Dic. 97)	-19800	2807	97912	Francisco Álvarez Cascos				19800
16/12/1997	16-12-1997	Galicia (O.C.)	18000		115912	Galicia			18000	
22/12/1997	22-12-1997	M.R. (Jul. Dic. 97)	-12600	2593	103312	Mariano Rajoy				12600
31/12/1997	31-12-1997	Acta Are (Julio-Dic.97)	-2400	193	100912	Javier Arenas				2400
31/12/1997	31-12-1997	Acta Are (Julio-Dic.97)	-12000		88912	Javier Arenas				12000
01/1998	15-01-1998	PAC de oct. a Diciem 97	-4356	22434	84556	Francisco Álvarez Cascos				4356
4/2/1998	04-02-1998	Galicia (O.C.)	18000	6193	102556	Galicia			18000	
?	15-02-1998	J.M. (Jul-Dic. 97)	-12600		89956	Jaime Mayor Oreja				12600
03/1998	15-03-1998	PAC de ener. a marzo 98	-4446	22434	85510	Francisco Álvarez Cascos				4446
04/1998	15-04-1998	Generales des	30000	23593	115510	Générale des Eaux			30000	
05/1998	15-05-1998	Gre. (Rafael P.)	30000	53592	145510	Rafael Palencia			30000	
05/1998	15-05-1998	Galicia (O.C.)	18000	71593	163510	Galicia			18000	
05/1998	15-05-1998	Acta Arens (Enero- Junio 98)	-14400	57193	149110	Javier Arenas				14400
06/1998	15-06-1998	PAC de abr.a junio 98	-4446	13542	144664	Francisco Álvarez Cascos				4446
06/1998	15-06-1998	Acta R. Rat (Enero-Junio  98)	-13680	43513	130984	Rodrigo Rato				13680
06/1998	15-06-1998	Acta Paco A.C. (Enero- Junio 98	-19800	23713	111184	Francisco Álvarez Cascos				19800
06/1998	15-06-1998	Acta Jaime (Enero- Junio 98)	-12600	11113	98584	Jaime Mayor Oreja				12600
06/1998	15-06-1998	Acta M. Raj (Enero- Junio 98)	-12600	1487	85984	Mariano Rajoy				12600
09/1998	15-09-1998	entrega de PAC	30000	43542	115984	Francisco Álvarez Cascos			30000	
09/1998	15-09-1998	Acta J.A. de Julio a Dic.	-6000	7487	109984	Javier Arenas				6000
11/1998	15-11-1998	De Málaga	18000	10513	127984	Málaga			18000	
11/1998	15-11-1998	López Hierro	24000	34513	151984	Ignacio López del Hierro			24000	
11/1998	15-11-1998	J.A. (resto de Jul. A Dic.)	-8400		143584	Javier Arenas				8400
12/1998	15-12-1998	M. Raj. (Julio a Dic.)	-12600		130984	Mariano Rajoy				12600
12/1998	15-12-1998	R. Rat (Julio a Dic.)	-13680	167	117304	Rodrigo Rato				13680
12/1998	15-12-1998	A. Ga Pozu.	24000		141304	Alfonso García Pozuelo			24000	
12/1998	15-12-1998	Jaime (Resto de Jul. A Dic.)	-12600		128704	Jaime Mayor Oreja				12600
01/1999	15-01-1999	Moreno (A. de la P.)	6000		134704	José Luis Moreno			6000	
02/1999	15-02-1999	Moreno (A. de la P.)	6000		140704	José Luis Moreno			6000	
02/1999	15-02-1999	J. Ar. (liquidación a Enero)	-4200	19033	136504	Javier Arenas				4200
04/1999	15-04-1999	De Málaga	18000		154504	Málaga			18000	
04/1999	15-04-1999	Moreno (A. de la P.)	6000		160504	José Luis Moreno			6000	
04/1999	15-04-1999	Lucio	24000		184504	Lucio Moreno			24000	
05/1999	15-05-1999	P. Crespo	126000		310504	Pablo Crespo	confirmado		126000	
05/1999	15-05-1999	M. Rajoy (En.- Junio 99)	-12600		297904	Mariano Rajoy				12600
05/1999	15-05-1999	Jaime M. (En. - Junio 99)	-12600		285304	Jaime Mayor Oreja				12600
05/1999	15-05-1999	Acta Paco A.C. (Juli.-Dic.98)	-19800		265504	Francisco Álvarez Cascos				19800
05/1999	15-05-1999	Paco A.C. (En.-Junio 99)	-19800		245704	Francisco Álvarez Cascos				19800
05/1999	15-05-1999	R.Rato (En.-Junio 99)	-13680		232024	Rodrigo Rato				13680
06/1999	15-06-1999	Javier Arenas (pagos varios)	-12000		220024	Javier Arenas				12000
06/1999	15-06-1999	Moreno (A. de la P.)	6000	108553	226024	José Luis Moreno			6000	
07/1999	15-07-1999	Entrega a Álvaro Lap.(País Vasco) para Abascal	-12000	96553	214024	Santiago Abascal				12000
09/1999	15-09-1999	De Málaga	18000	114553	232024	Málaga			18000	
10/1999	15-10-1999	R.Rato (2do Semestre 99)	-13680		218344	Rodrigo Rato				13680
11/1999	15-11-1999	M. Rajoy (2do semestre 99)	-12600		205744	Mariano Rajoy				12600
?	15-11-1999	Paco A.C. (2do semestre 99)	-19800		185944	Francisco Álvarez Cascos				19800
?	15-11-1999	Jaime Mayor	-12600		173344	Jaime Mayor Oreja				12600
01/2000	15-01-2000	Moreno a A. de la P.	6000	61873	179344	José Luis Moreno			6000	
01/2000	15-01-2000	Lucio	12000	73873	191344	Lucio Moreno			12000	
01/2000	15-01-2000	Alfonso Gª Pozuelo	1800	67873	193144	Alfonso García Pozuelo			1800	
02/2000	15-02-2000	De Málaga	18000	121873	211144	Málaga			18000	
02/2000	15-02-2000	R. Palenc.	24000	145873	235144	Rafael Palencia			24000	
03/2000	15-03-2000	Moreno a A. de la P.	9000	151873	244144	José Luis Moreno			9000	
04/2000	15-04-2000	1º Trimestre R. Rato	-6840		237304	Rodrigo Rato				6840
04/2000	15-04-2000	1º Trimestre Mariano R.	-6300		231004	Mariano Rajoy				6300
04/2000	15-04-2000	1º Trimestre Jaime M	-6300		224704	Jaime Mayor Oreja				6300
04/2000	15-04-2000	1º Trimestre P.A.C.	-9900		214804	Francisco Álvarez Cascos				9900
04/2000	15-04-2000	Regalos	-3561		211243	Javier Arenas				3561
05/2000	15-05-2000	Moreno	6000		217243	José Luis Moreno			6000	
05/2000	15-05-2000	De Málaga	18000		235243	Málaga			18000	
05/2000	15-05-2000	Moreno	6000		241243	José Luis Moreno			6000	
06/2000	15-06-2000	Copa Crespo	30000	178972	271243	Pablo Crespo			30000	
07/2000	15-07-2000	Amigo diputados grupo	12000	190972	283243	Diputados			12000	
07/2000	15-07-2000	2º Trimestre Mariano R.	-6300		276943	Mariano Rajoy				6300
07/2000	15-07-2000	2º Trimestre Jaime M.	-6300		270643	Jaime Mayor Oreja				6300
07/2000	15-07-2000	Cancelación cto. Concejal Málaga	-12090		258553	José María Martín Carpena				12090
07/2000	15-07-2000	2º Trimestre R. Rato	-6840	159442	251713	Rodrigo Rato				6840
07/2000	15-07-2000	Cancelac. Concejal Málaga Unicaja	-960	160402	250753	José María Martín Carpena				960
07/2000	15-07-2000	Alfonso Gª Pozuelo	12000		262753	Alfonso García Pozuelo			12000	
07/2000	15-07-2000	Cancelación Cto. Concejal Durango	-33000		229753	Jesús María Pedrosa Urquiza				33000
08/2000	15-08-2000	Acta. FEDERICO*	-12000	127402	217753	Federico Trillo				12000
09/2000	15-09-2000	2o Trimestre P.A.C.	-9900	117502	207853	Francisco Álvarez Cascos				9900
09/2000	15-09-2000	Amigo diputado grupo (Jose Ma Rubio)	6000		213853	José Manuel Fernández Rubio			6000	
09/2000	15-09-2000	De Málaga	18000	141502	231853	Málaga			18000	
10/2000	15-10-2000	Coche San Adriá	-22770		209083	José Luis Ruiz Casado				22770
11/2000	15-11-2000	3o y 4o Trimestre R. Rato	-13680		195403	Rodrigo Rato				13680
11/2000	15-11-2000	3o y 4o Trimestre J. Mayor	-12600	92416	182803	Jaime Mayor Oreja				12600
11/2000	15-11-2000	De Málaga	18000		200803	Málaga			18000	
11/2000	15-11-2000	De Alfonso Ga Poz	30000	140452	230803	Alfonso García Pozuelo			30000	
12/2000	15-12-2000	Lucio Moreno	12000		242803	Lucio Moreno			12000	
12/2000	15-12-2000	Moreno	6000		248803	José Luis Moreno			6000	
12/2000	15-12-2000	R. Palencia	15000	173452	263803	Rafael Palencia			15000	
12/2000	15-12-2000	M. Rajoy 3o y 4o trimestre	-12600		251203	Mariano Rajoy				12600
12/2000	15-12-2000	Paco A.C. 3o y 4o trimestre	-19800	141052	231403	Francisco Álvarez Cascos				19800
01/2001	15-01-2001	J.M. Rubio	6000	147052	237403	José Manuel Fernández Rubio			6000	
01/2001	15-01-2001	Federico *	-18000	129052	219403	Federico Trillo				18000
01/2001	15-01-2001	Celicio Sanch. (Aguas)	30000	159052	249403	Cecilio Sánchez Martín			30000	
02/2001	15-02-2001	J.M. Rubio	12000	171052	261403	José Manuel Fernández Rubio			12000	
03/2001	15-03-2001	Especial Jaime	-6000	165052	255403	Jaime Mayor Oreja				6000
04/2001	15-04-2001	Málaga	18000	183052	273403	Málaga			18000	
04/2001	15-04-2001	J.M. Rubio	30000	213052	303403	José Manuel Fernández Rubio			30000	
04/2001	15-04-2001	1º Semestre 2001 Mariano	-12600	200452	290803	Mariano Rajoy				12600
04/2001	15-04-2001	Moreno	6000	206452	296803	José Luis Moreno			6000	
04/2001	15-04-2001	Federico (resto 2000) *	-8166	198286	288637	Federico Trillo				8166
04/2001	15-04-2001	País Vasco Mª Eug. Rico (Álvaro)	-2700		285937	María Eugenia García Rico				2700
05/2001	15-05-2001	1º Semestre 2001 Rodrigo	-13680	181906	272257	Rodrigo Rato				13680
06/2001	15-06-2001	Málaga	18000		290257	Málaga			18000	
06/2001	15-06-2001	1º Semestre 2001 Jaime	-12600	187306	277657	Jaime Mayor Oreja				12600
07/2001	15-07-2001	Jaime Ignacio	-3000		274657	Jaime Ignacio del Burgo	confirmado			3000
07/2001	15-07-2001	Concejal Viuda Francisco Cano (Barcelona)	-18000	166306	256657	Francisco Cano	confirmado			18000
07/2001	15-07-2001	1º Semestre Paco Álv-Cascos	-19800	148306	236857	Francisco Álvarez Cascos				19800
07/2001	15-06-2001	Federico correspondiente a 2001 *	-18000	128506	218857	Federico Trillo				18000
09/2001	15-09-2001	Deuda Tenerife telemarketing	-27600	100906	191257	Tenerife				27600
09/2001	15-09-2001	2º Semestre 2001 Rodrigo R.	-13680	87226	177577	Rodrigo Rato				13680
09/2001	15-09-2001	2º Semestre 2001Mariano	-12600	74626	164977	Mariano Rajoy				12600
11/2001	15-11-2001	2º Semestre 2001 Paco A.Cascos	-19800	54826	145177	Francisco Álvarez Cascos				19800
11/2001	15-12-2001	Liquidación Linaza (León)	-15000	39826	130177	Luis Guillermo López Linaza				15000
12/2001	15-12-2001	Resto año 2001 Federico Trillo *	-18000		112177	Federico Trillo				18000
12/2001	15-12-2001	A Pio García Escudero (devol. Antic. Atentado)	-6000		106177	Pio García Escudero	confirmado			6000
12/2001	15-12-2001	Federico	-3000		103177	Federico Trillo				3000
12/2001	15-01-2002	A Jaime Mayor	-12000	826	91177	Jaime Mayor Oreja				12000
2002	15-05-2002	Aportación Manuel Contreras	60000	60000	151177	Manuel Contreras			60000	
?	15-05-2002	Liq. 2001 Federico	-19470		131707	Federico Trillo				19470
?	15-05-2002	1º Semestre 2002 Mariano ...	-12620		119087	Mariano Rajoy				12620
?	15-05-2002	1º Semestre 2002 Rodrigo	-13700		105387	Rodrigo Rato				13700
?	15-05-2002	Jose Luis S.	50000		155387	José Luis Sánchez			50000	
?	15-05-2002	Entrega Amparo Bordá (Jaime)	-15000		140387	Amparo Bordá				15000
?	15-05-2002	M. Contreras	30000		170387	Manuel Contreras			30000	
?	15-05-2002	1º Semestre Cascos	-19860	59350	150527	Francisco Álvarez Cascos				19860
?	15-05-2002	Alfonso Gª Poz.	24000		174527	Alfonso García Pozuelo			24000	
?	15-05-2002	Jaime (Basta Ya)	-3005		171522	Jaime Mayor Oreja				3005
?	15-05-2002	J. M. Fdez Rubio	18000	98345	189522	José Manuel Fernández Rubio			18000	
07/2002	15-07-2002	Jose Luis	100000	198345	289522	José Luis Sánchez			100000	
07/2002	15-07-2002	Pedro Arriola	-60000		229522	Pedro Arriola				60000
07/2002	15-07-2002	J.M. Fernández Rubio	18000		247522	José Manuel Fernández Rubio			18000	
07/2002	15-07-2002	Jaime Mayor	-7500	148845	240022	Jaime Mayor Oreja				7500
07/2002	15-07-2002	1º semestre Federico	-27760		212262	Federico Trillo				27760
07/2002	15-07-2002	Liquidación Javier	-3050		209212	Javier Arenas				3050
07/2002	15-07-2002	Mes de julio Javier	-3300		205912	Javier Arenas				3300
09/2002	15-09-2002	2º semestre Rodrigo	-13700	101035	192212	Rodrigo Rato				13700
09/2002	15-09-2002	Jose Luis	100000	201035	292212	José Luis Sánchez			100000	
09/2002	15-09-2002	Mes de Agosto y Sept. Javier	-6600		285612	Javier Arenas				6600
09/2002	15-09-2002	2º Semestre Mariano	-12620	181815	272992	Mariano Rajoy				12620
10/2002	15-10-2002	2º Semestre Cascos	-19860		253132	Francisco Álvarez Cascos				19860
10/2002	15-10-2002	Oct. Nov. Dic Javier	-9900		243232	Javier Arenas				9900
10/2002	15-10-2002	2º Semestre Federico	-27760		215472	Federico Trillo				27760
10/2002	15-10-2002	Extra 15º Javier	-8400	115895	207072	Javier Arenas				8400
11/2002	15-11-2002	Pedro Arriola	-100000	15895	107072	Pedro Arriola				100000
12/2002	15-12-2002	A Javier Arenas	-12000	3895	95072	Javier Arenas				12000
12/2002	15-12-2002	A Euroconsumo	-4500		90572	Euroconsumo				4500
12/2002	15-12-2002	De J. M. F. Rubio	18000		108572	José Manuel Fernández Rubio			18000	
12/2002	15-12-2002	A Jaime Mayor	-12000	5395	96572	Jaime Mayor Oreja				12000
12/2002	15-12-2002	A c/c donativos B. Vitor.	-5395		91177	Donativo				5395
16/01/2003	16-01-2003	M. Contreras	60000		151177	Manuel Contreras			60000	
4/2/2003	04-02-2003	J.L.Sánchez	100000	160000	251177	José Luis Sánchez			100000	
02/2003	15-02-2003	1º Semestre Javier (3300/mes)	-19800		231377	Javier Arenas				19800
02/2003	15-02-2003	1º Semestre Rodrigo R.	-13700		217677	Rodrigo Rato				13700
6/2/2003	06-02-2003	Rubio	18000		235677	José Manuel Fernández Rubio			18000	
6/2/2003	06-02-2003	Camilo (Sisocia)	60000		295677	Camilo José Alcalá Sánchez			60000	
24/02/2003	24-02-2003	1º Semestre Mariano	-12620		283057	Mariano Rajoy				12620
27/02/2003	27-02-2003	1º Semestre Paco	-19860		263197	Francisco Álvarez Cascos				19860
3/3/2003	03-03-2003	Ángel Salado	60000		323197	Ángel Salado			60000	
4/3/2003	04-03-2003	Donativo a Euroconsumo	-1100		322097	Euroconsumo				1100
11/3/2003	11-03-2003	Copisa / Socique	100000	270920	422097	Ramón Aige Sánchez			100000	
27/03/2003	27-03-2003	Pedro Arriola	-120000	150920	302097	Pedro Arriola				120000
31/03/2003	31-03-2003	Congregación	-4100	146820	297997	Congregación				4100
31/03/2003	31-03-2003	Jose L. Moreno	6000	152820	303997	José Luis Moreno			6000	
2/4/2003	02-04-2003	M. Contreras	60000	212820	363997	Manuel Contreras			60000	
2/4/2003	02-04-2003	A Matas para piso	-8400		355597	Jaime Matas				8400
24/04/2003	24-04-2003	Aldesa	18000		373597	José Manuel Fernández Rubio			18000	
29/04/2003	29-04-2003	Teofila Martínez	-30000		343597	Teofila Martínez				30000
30/04/2003	30-04-2003	Jerez (el Lili)	-6000		337597	Aurelio Romero				6000
5/5/2003	05-05-2003	De Javier (L. del R.)	100000		437597	Luis del Rivero			100000	
13/05/2003	13-05-2003	Polo/Llorens	30000		467597	José Antonio Romero Polo			30000	
6/5/2003	06-05-2003	Copisa / Socique	100000		567597	Copisa y Sorigué			100000	
25/05/2003	25-05-2003	Rubio	18000	431420	585597	José Manuel Fernández Rubio			18000	
2/6/2003	02-06-2003	Lérida (J.I. Llorens)	-6000	428420	579597	José Ignacio Llorens				6000
16/06/2003	16-06-2003	J.L. Sánchez	100000		679597	José Luis Sánchez			100000	
17/06/2003	17-06-2003	Liquidación Arriola	-161000	367420	518597	Pedro Arriola				161000
25/06/2003	25-06-2003	M. Contreras	120000		638597	Manuel Contreras			120000	
1/7/2003	01-07-2003	Federico año 2003 completo	-36000		602597	Federico Trillo				36000
2/7/2003	02-07-2003	Rubio	30000	481420	632597	José Manuel Fernández Rubio			30000	
8/7/2003	08-07-2003	Pio Gª (15ºpaga)	-6000		626597	Pio García Escudero	confirmado			6000
16/07/2003	16-07-2003	2º Semestre Rodrigo	-13700		612897	Rodrigo Rato				13700
16/07/2003	16-07-2003	2º Semestre Javier	-19800		593097	Javier Arenas				19800
16/07/2003	16-07-2003	Paco Álvarez (2º Semestre)	-19800		573297	Francisco Álvarez Cascos				19800
16/07/2003	16-07-2003	2º Semestre Mariano	-12600	409520	560697	Mariano Rajoy				12600
29/07/2003	29-07-2003	Jaime Mayor	-7500	402020	553197	Jaime Mayor Oreja				7500
11/9/2003	11-09-2003	J.L. Sánchez	100000	502020	653197	José Luis Sánchez			100000	
15/09/2003	15-09-2003	Reloj Javier Arenas	-700		652497	Javier Arenas				700
26/09/2003	26-09-2003	Ingresado en Banco Vitoria	-50000	451320	602497	Banco Vitoria				50000
3/10/2003	03-10-2003	Manuel Contreras	120000		722497	Manuel Contreras			120000	
6/10/2003	06-10-2003	Ingresado en Banco Vitoria	-120000	451320	602497	Banco Vitoria				120000
22/10/2003	22-10-2003	Guillermo Contreras	30000		632497	Guillermo Contreras			30000	
17/11/2003	17-11-2003	J.L.Sánchez (otros 100 a Javier)	100000	551320	702497	José Luis Sánchez			100000	
18/11/2003	18-11-2003	Extra 15º Mariano Rajoy	-8420	542920	694077	Mariano Rajoy				8420
2/12/2003	02-12-2003	Entrega a Javier Rojas	-198000	344900	496077	Javier Rojo Redondo				198000
4/12/2003	04-12-2003	Alfonso Gª Pozuelo	60000	404900	556077	Alfonso García Pozuelo			60000	
10/12/2003	10-12-2003	Rubio	24000	428900	580077	José Manuel Fernández Rubio			24000	
12/12/2003	12-12-2003	Camilo	90000	518900	670077	Camilo José Alcalá Sánchez			90000	
17/12/2003	17-12-2003	Jaime Mayor	-12000	506900	658077	Jaime Mayor Oreja				12000
7/1/2004	07-01-2004	Ingresos en B. Vitoria	-206900	300000	451177	Donativo				206900
8/1/2004	08-01-2004	1º Trimestre Rodrigo Rato	-6850		444327	Rodrigo Rato				6850
12/1/2004	12-01-2004	Aldesa	24000		468327	José Manuel Fernández Rubio			24000	
14/01/2004	14-01-2004	1º Trimestre J. Arenas	-9900		458427	Javier Arenas				9900
22/01/2004	22-01-2004	M. Contreras	120000		578427	Manuel Contreras			120000	
01/2004	15-01-2004	Fund. Hum. Y D. (Pin)	-40000		538427	Fundación Humanismo y Democracia				40000
5/2/2004	05-02-2004	Elvira	-6000		532427	Elvira Rodríguez				6000
5/2/2004	05-02-2004	Aldesa	48000	429250	580427	José Manuel Fernández Rubio			48000	
10/2/2004	10-02-2004	Ana Palacios	-6000		574427	Ana Palacio				6000
10/2/2004	10-02-2004	Pilar Castillo	-6000		568427	Pilar del Castillo				6000
10/2/2004	10-02-2004	Cantabria	-60000		508427	Cantabria				60000
10/2/2004	10-02-2004	1º Trimestre Mariano	-6300	350950	502127	Mariano Rajoy				6300
17/02/2004	17-02-2004	Romero Polo (Lérida)	24000	374950	526127	José Antonio Romero Polo			24000	
19/02/2004	19-02-2004	Mariano cuota dip. Madrid	-1000	373950	525127	Mariano Rajoy				1000
24/02/2004	24-02-2004	J.L.Sánchez	100000		625127	José Luis Sánchez			100000	
24/02/2004	24-02-2004	A. Sevilla	-50000		575127	Sevilla				50000
24/02/2004	24-02-2004	A Málaga	-20000	403950	555127	Málaga				20000
1/3/2004	01-03-2004	Ruban (Antonio Vilella)	50000	453950	605127	Antonio Vilella			50000	
1/3/2004	01-03-2004	Copasa	75000	528950	680127	Copasa			75000	
2/3/2004	02-03-2004	Ubaldo Nieto	3000	531950	683127	Ubaldo Nieto			3000	
8/3/2004	08-03-2004	Fdez. Rubio	48000		731127	José Manuel Fernández Rubio			48000	
10/3/2004	10-03-2004	Pilar Castillo	-3000		728127	Pilar del Castillo				3000
11/3/2004	11-03-2004	Juan Cotino (Sedesa)	200000		928127	Vicente Cotino Escrivá			200000	
11/3/2004	11-03-2004	A. Villela	50000		978127	Antonio Vilella			50000	
15/03/2004	15-03-2004	Mercadona	90000	916950	1068127	Mercadona			90000	
20/04/2004	20-04-2004	1º trimestre Cascos	-9900		1058227	Francisco Álvarez Cascos				9900
26/04/2004	26-04-2004	15º de A. de la P.	-8200	898850	1050027	Álvaro de la Puerta				8200
27/04/2004	27-04-2004	Ingresado en B. Vitoria-Banesto. Donativo	-100850	798000	949177	Donativo				100850
4/5/2004	04-05-2004	Ingresado en B. Vitoria-Banesto. Donativo	-100000	698000	849177	Donativo				100000
6/5/2004	06-05-2004	Pago a J. Rojo (Campaña)	-280000	418000	569177	Javier Rojo Redondo				280000
14/05/2004	14-05-2004	Ingresado en Banesto Donativos	-118000	300000	451177	Donativo				118000
14/05/2004	14-05-2004	Mariano Rajoy 2º Trimestre	-6300		444877	Mariano Rajoy				6300
14/05/2004	14-05-2004	Ángel Acebes 2º Trimestre (1º pago)	-6300		438577	Ángel Acebes				6300
14/05/2004	14-05-2004	Javier Arenas 2º Trimestre	-9900	277500	428677	Javier Arenas				9900
25/05/2004	25-05-2004	Ingresado en Banesto Donativos	-77500	200000	351177	Donativo				77500
4/6/2004	04-06-2004	Cantabria Campaña	-30000	170000	321177	Cantabria				30000
4/6/2004	04-06-2004	Ingresado en Banesto Donativos	-100000	70000	221177	Donativo				100000
9/6/2004	09-06-2004	Jose Luis Sánchez	100000	170000	321177	José Luis Sánchez			100000	
11/6/2004	11-06-2004	Volpeceres	60000	230000	381177	Joaquín Molpeceres Sánchez			60000	
11/6/2004	11-06-2004	Alfonso Gª Poz	30000	260000	411177	Alfonso García Pozuelo			30000	
24/06/2004	24-06-2004	Colaboración Asesoria (Álvaro)	-2100		409077	Álvaro Lapuerta				2100
7/7/2004	07-07-2004	Campaña Europes	-100000		309077	Campaña Europeas				100000
14/07/2004	14-07-2004	Ángel Acebes 3º Trimestre	-6300		302777	Ángel Acebes				6300
18/07/2004	18-07-2004	Mariano Rajoy	-6300		296477	Mariano Rajoy				6300
28/07/2004	28-07-2004	Luis Fraga [Guadalajara]	-3000		293477	Luis Fraga				3000
14/09/2004	14-09-2004	Jose Luis Sánchez	100000		393477	José Luis Sánchez			100000	
21/09/2004	21-09-2004	Ángel Acebes 4º trimestre	-6300		387177	Ángel Acebes				6300
21/09/2004	21-09-2004	Mariano Rajoy 4º trimestre	-6300	229700	380877	Mariano Rajoy				6300
22/09/2004	22-09-2004	Luis de Rivero	120000		500877	Luis del Rivero			120000	
22/09/2004	22-09-2004	Manuel Contreras	60000	409700	560877	Manuel Contreras			60000	
19/10/2004	19-10-2004	Villar Mir	100000	509700	660877	Juan Manuel Villar Mir			100000	
20/10/2004	20-10-2004	A c/c donativos	-60000	449700	600877	Donativo				60000
20/10/2004	20-10-2004	Entrega a Paco Yáñez para suscribir 1.100 titulos	-121000	328700	479877	Paco Yáñez				121000
29/10/2004	29-10-2004	Entrega a Álvaro Lapuerta 1.270 titulos	-139700	189000	340177	Álvaro Lapuerta				139700
26/11/2004	26-11-2004	Entrega Pozuelo (Hispánica)	30000	69400	370177	Alfonso García Pozuelo			30000	
3/12/2004	03-12-2004	Compra Alberto Dorrego Libertad Digital	-12100	57300	358077	Alberto Dorrego				12100
14/12/2004	14-12-2004	Compra Alberto Dorrego Libertad Digital	-24000		334077	Alberto Dorrego				24000
23/12/2004	23-12-2004	Devolución Paco Yáñez	121000	154300	455077	Paco Yáñez			121000	
12/1/2005	12-01-2005	Ingresados en c/c Donativos	-111840	42460	343237	Donativo				111840
24/01/2005	24-01-2005	1º Trimestre Ángel Acebes	-6300		336937	Ángel Acebes				6300
24/01/2005	24-01-2005	1º Trimestre Mariano Rajoy	-6300	29860	330637	Mariano Rajoy				6300
26/01/2005	26-01-2005	Entrega Federico Trillo	-12000	17860	318637	Federico Trillo				12000
31/03/2005	31-03-2005	Entrega gastos Paco Yáñez L. Digital	-950		317687	Paco Yáñez				950
4/5/2005	05-04-2005	Entrega gastos Rosa Iglesias L. Digital	-650		317037	Rosa Iglesias				650
18/05/2005	18-05-2005	2º Trimestre 2005 Mariano	-6300		310737	Mariano Rajoy				6300
18/05/2005	18-05-2005	2º Trimestre 2005 Ángel A.	-6300	3660	304437	Ángel Acebes				6300
20/05/2005	20-05-2005	Manuel Contreras	48000	51660	352437	Manuel Contreras			48000	
26/07/2005	26-07-2005	3º Trimestre 2005 Mariano	-6300	45360	346137	Mariano Rajoy				6300
26/07/2005	26-07-2005	3º Trimestre 2005 Ángel A.	-6300	39060	339837	Ángel Acebes				6300
17/06/2005	17-06-2005	Liq. Paco Yáñez	-210	38850	339627	Paco Yáñez				210
10/10/2005	10-10-2005	4º Trimestre 2005 Mariano	-6300		333327	Mariano Rajoy				6300
10/10/2005	10-10-2005	4º Trimestre 2005 Ángel	-6300	26250	327027	Ángel Acebes				6300
24/11/2005	24-11-2005	Ingresado en Banesto Donativos	-26090		300937	Donativo				26090
01/2006	15-01-2006	Ant. Pinol	12000		312937	Antonio Pinal Gil			12000	
01/2006	15-01-2006	Vta. Aces P.Y. a Álvaro Cruz gastos	-315	11685	312622	Ángel Acebes, Paco Yáñez, Álvaro de la Cruz				315
01/2006	15-01-2006	Pilar (Empresa Estudios) Pulido	12000		324622	Pilar Pulido			12000	
1/2/2006	01-02-2006	1º Trimestre Mariano	-6300		318322	Mariano Rajoy				6300
1/2/2006	01-02-2006	1º Trimestre Ángel	-6300	11085	312022	Ángel Acebes				6300
04/2006	15-04-2006	Alfonso Gª Pozuelo	18000		330022	Alfonso García Pozuelo			18000	
04/2006	15-04-2006	2º Trimestre Mariano	-6300		323722	Mariano Rajoy				6300
04/2006	15-04-2006	2º Trimestre Ángel	-6300	16485	317422	Ángel Acebes				6300
06/2006	15-06-2006	Corbatas Presidente	-667	15818	316755	Mariano Rajoy				667
06/2006	15-06-2006	Adolfo Sánchez	12000		328755	Adolfo Sánchez			12000	
07/2006	15-07-2006	3º Trimestre Mariano	-6300		322455	Mariano Rajoy				6300
07/2006	15-07-2006	3º Trimestre Ángel	-6300	15218	316155	Ángel Acebes				6300
14/07/2006	14-07-2006	Trajes y camisas	-5720	9498	310435	Mariano Rajoy				5720
26/07/2006	26-07-2006	Federico Trillo	-3000	6498	307435	Federico Trillo				3000
14/09/2006	14-09-2006	Antonio Pinal / Emilio	12000		319435	Antonio Pinal Gil			12000	
2/10/2006	02-10-2006	4º Trimestre Mariano	-6300		313135	Mariano Rajoy				6300
2/10/2006	02-10-2006	4º Trimestre Ángel	-6300	5898	306835	Ángel Acebes				6300
25/10/2006	25-10-2006	J.M. Villar Mir	180000		486835	Juan Manuel Villar Mir			180000	
26/10/2006	26-10-2006	Ingresado B. Banesto	-80000	105898	406835	Donativo				80000
31/10/2006	31-10-2006	Adolfo Sánchez	10000		416835	Adolfo Sánchez			10000	
6/11/2006	06-11-2006	Luis Rivero	60000		476835	Luis del Rivero			60000	
15/11/2006	15-11-2006	M. Contreras	60000		536835	Manuel Contreras			60000	
15/11/2006	15-11-2006	Emilia Álvarez	12000		548835	Emilio Álvarez			12000	
23/11/2006	23-11-2006	Arquitecto Gonzalo Urquijo	-184000	63898	364835	Gonzalo Urquijo				184000
13/12/2006	13-12-2006	Adolfo Sánchez	9500		374335	Adolfo Sánchez			9500	
19/12/2006	19-12-2006	J.L.Sánchez	100000		474335	José Luis Sánchez			100000	
21/12/2006	21-12-2006	Emilia Álvarez	12000		486335	Emilio Álvarez			12000	
21/12/2006	21-12-2006	Traje Mariano	-9100	176298	477235	Mariano Rajoy				9100
9/1/2007	09-01-2007	Ingresar en Donativos	-53000	123298	424235	Donativo				53000
9/1/2007	09-01-2007	1º Trimestre Mariano	-6300		417935	Mariano Rajoy				6300
9/1/2007	09-01-2007	1º Trimestre Ángel	-6300	110698	411635	Ángel Acebes				6300
10/1/2007	10-01-2007	Ingresar en Donativos	-60000	50698	351635	Donativo				60000
7/3/2007	07-03-2007	de J.L. para Andalucía	-30000	20698	321635	José Luis Sánchez				30000
21/03/2007	21-03-2007	Ignacio Ugarteche (C. Sanz)	90000		411635	Ignacio Ugarteche Gonzáles de Lanagarica			90000	
26/03/2007	26-03-2007	Entrega a Cantabria	-60000	50698	351635	Cantabria				60000
11/4/2007	11-04-2007	Entrega a Álvaro Lap. Para Alberto Fdez	-30000	20698	321635	Álvaro Lapuerta, Alberto Fernández				30000
25/04/2007	25-04-2007	Entrega a Cristobal Páez	-6000	14698	315635	Cristobal Páez	confirmado			6000
25/04/2007	25-04-2007	2º Trimestre Mariano	-6300		309335	Mariano Rajoy				6300
25/04/2007	25-04-2007	2º Trimestre Ángel	-6300	2098	303035	Ángel Acebes				6300
22/05/2007	22-05-2007	Rafa Palencia	35000		338035	Rafael Palencia			35000	
24/05/2007	24-05-2007	Manuel Contreras	60000		398035	Manuel Contreras			60000	
20/05/2007	20-05-2007	Sánchez Jose Luis	100000		498035	José Luis Sánchez			100000	
06/2007	15-06-2007	Entrega a J. Arenas	-30000	167098	468035	Javier Arenas				30000
06/2007	15-06-2007	Entrega a Adolfo Sánchez	12000		480035	Adolfo Sánchez			12000	
9/7/2007	09-07-2007	3º Trimestre Mariano	-6300		473735	Mariano Rajoy				6300
9/7/2007	09-07-2007	3º Trimestre Ángel Ac.	-6300		467435	Ángel Acebes				6300
20/07/2007	20-07-2007	Adolfo Sánchez	24000		491435	Adolfo Sánchez			24000	
09/2007	15-09-2007	Adolfo Sánchez	10000		501435	Adolfo Sánchez			10000	
10/2007	15-10-2007	4º Trimestre Mariano	-6300		495135	Mariano Rajoy				6300
10/2007	15-10-2007	4º Trimestre Ángel	-6300	187898	488835	Ángel Acebes				6300
7/11/2007	07-11-2007	Adolfo Sánchez	11000	198898	499835	Adolfo Sánchez			11000	
14/12/2007	14-12-2007	Luis Del R.	200000	398898	699835	Luis del Rivero			200000	
01/2008	15-01-2008	1º Semestre Mariano	-12600		687235	Mariano Rajoy				12600
01/2008	15-01-2008	1º Semestre Ángel	-12600	373698	674635	Ángel Acebes				12600
01/2008	15-01-2008	J. Luis Sánchez	100000	473698	774635	José Luis Sánchez			100000	
26/01/2008	26-01-2008	A Cantabria	-30000	443698	744635	Cantabria				30000
28/01/2008	28-01-2008	Gonz. Urquijo	-195000	248698	549635	Gonzalo Urquijo				195000
28/01/2008	28-01-2008	Ramón Aige	36000		585635	Ramón Aige Sánchez			36000	
31/01/2008	31-01-2008	País Vasco (Ignacio Aguirre)	-25000		560635	Ignacio Aguirre				25000
31/01/2008	31-01-2008	Lérida (J.L. Meres)	-30000		530635	J.L. Meres				30000
31/01/2008	31-01-2008	Cantabria	-30000		500635	Cantabria				30000
7/2/2008	07-02-2008	M. Contreras	60000		560635	Manuel Contreras			60000	
11/2/2008	11-02-2008	J.M. Villar Mir	250000	509698	810635	Juan Manuel Villar Mir			250000	
14/02/2008	14-02-2008	Luis Fraga	-6000	503698	804635	Luis Fraga				6000
20/02/2008	20-02-2008	Pilar Pulido	36000		840635	Pilar Pulido			36000	
22/02/2008	22-02-2008	Luis Gálvez	50000		890635	Luis Gálvez			50000	
27/02/2008	27-02-2008	Mercadona	150000	739698	1040635	Mercadona			150000	
3/3/2008	03-03-2008	De J.L.Sánchez a Sevilla	-50000		990635	José Luis Sánchez				50000
5/3/2008	05-03-2008	País Vasco (Ignacio Aguirre)	-25000		965635	Ignacio Aguirre				25000
10/3/2008	10-03-2008	Jose Mayor (FCC)	90000		1055635	Jose Mayor			90000	
13/03/2008	13-03-2008	De Ramón Aige a Sevilla	-18000		1037635	Sevilla				18000
13/03/2008	13-03-2008	Gonzalo (Arquitecto)	-258000		779635	Gonzalo Urquijo				258000
13/03/2008	13-03-2008	J. Rojo / Valls	-220000	258698	559635	Javier Rojo Redondo				220000
03/2008	15-03-2008	M.R. entrega Asesor	-3000	255698	556635	Mariano Rajoy				3000
31/03/2008	31-03-2008	Alv. Lapuerta a cambio de talón ingresado hoy	-60000	195698	496635	Álvaro Lapuerta				60000
18/04/2008	18-04-2008	Trajes M.R.	-11020		485615	Mariano Rajoy				11020
6/5/2008	06-05-2008	Rafael Palencia	30000		515615	Rafael Palencia			30000	
26/05/2008	26-05-2008	Entrega de La Rioja	200000	414678	715615	La Rioja			200000	
2/6/2008	02-06-2008	Entrega a Cristobal Paez	-6000		709615	Cristobal Páez	confirmado			6000
3/6/2008	03-06-2008	2º Semestre M. Rajoy	-12600	396078	697015	Mariano Rajoy				12600
25/06/2008	25-06-2008	Ramón Aige	18000		715015	Ramón Aige Sánchez			18000	
30/06/2008	30-06-2008	Adolfo Sanchez	10000	424078	725015	Adolfo Sánchez			10000	
3/7/2008	03-07-2008	Jose Mayor	75000	499078	800015	Jose Mayor			75000	
7/7/2008	07-07-2008	D. Cospedal 3º trimestre 2500 x 3	-7500		792515	Dolores de Cospedal				7500
15/07/2008	15-07-2008	Regul. M. Raj 2º Semestre 400 x 6	-2400		790115	Mariano Rajoy				2400
22/07/2008	22-07-2008	Entrega a J. I. de Ramón Aige	-6000		784115	José Ignacio Llorens				6000
22/07/2008	22-07-2008	Regalo Álvaro Lap.	-1490		782625	Álvaro Lapuerta				1490
31/07/2008	31-07-2008	Gonzalo Urquijo (3º Planta)	-235000	246688	547625	Gonzalo Urquijo				235000
14/10/2008	14-10-2008	D. Cospedal 4º Trimestre	-7500	239188	540125	Dolores de Cospedal				7500
10/2008	15-10-2008	Entrega M.C	10000	249188	550125	Manuel Contreras			10000	
12/2008	15-12-2008	G.U.	-200000	49188	350125	Gonzalo Urquijo				200000
23-06-2000	23-06-2000	Ingreso en Dresdner Bank	-59800.7			Luis Bárcenas	confirmado
02-07-2000	02-07-2000	Ingreso en Dresdner Bank	-114192.3			Luis Bárcenas	confirmado
29-01-2001	29-01-2001	Ingreso en Dresdner Bank	-30050.61			Luis Bárcenas	confirmado
17-05-2001	17-05-2001	Ingreso en Dresdner Bank	-108182.18			Luis Bárcenas	confirmado
15-06-2001	15-06-2001	Ingreso en Dresdner Bank	-138232.78			Luis Bárcenas	confirmado
29-06-2001	29-06-2001	Ingreso en Dresdner Bank	-120202.42			Luis Bárcenas	confirmado
20-07-2001	20-07-2001	Ingreso en Dresdner Bank	-150313.13			Luis Bárcenas	confirmado
10-09-2001	10-09-2001	Ingreso en Dresdner Bank	-48080.97			Luis Bárcenas	confirmado
12-10-2001	12-10-2001	Ingreso en Dresdner Bank	-120202.42			Luis Bárcenas	confirmado
17-12-2001	17-12-2001	Ingreso en Dresdner Bank	-54091.09			Luis Bárcenas	confirmado
21-12-2001	21-12-2001	Ingreso en Dresdner Bank	-120923.64			Luis Bárcenas	confirmado
22-03-2002	22-03-2002	Ingreso en Dresdner Bank	-140000			Luis Bárcenas	confirmado
31-05-2002	31-05-2002	Ingreso en Dresdner Bank	-105000			Luis Bárcenas	confirmado
12-07-2002	12-07-2002	Ingreso en Dresdner Bank	-239000			Luis Bárcenas	confirmado
10-01-2003	10-01-2003	Ingreso en Dresdner Bank	-20000			Luis Bárcenas	confirmado
13-01-2003	13-01-2003	Ingreso en Dresdner Bank	-67000			Luis Bárcenas	confirmado
07-03-2003	07-03-2003	Ingreso en Ingreso en Lombard Odier	-180000			Luis Bárcenas	confirmado
21-03-2003	21-03-2003	Ingreso en Ingreso en Lombard Odier	-180000			Luis Bárcenas	confirmado
04-04-2003	04-04-2003	Ingreso en Ingreso en Lombard Odier	-190000			Luis Bárcenas	confirmado
02-05-2003	02-05-2003	Ingreso en Dresdner Bank	-162500			Luis Bárcenas	confirmado
04-06-2003	04-06-2003	Ingreso en Ingreso en Lombard Odier	-180000			Luis Bárcenas	confirmado
30-06-2003	30-06-2003	Ingreso en Dresdner Bank	-120000			Luis Bárcenas	confirmado
11-07-2003	11-07-2003	Ingreso en Dresdner Bank	-151000			Luis Bárcenas	confirmado
11-07-2003	11-07-2003	Ingreso en Dresdner Bank	-60000			Luis Bárcenas	confirmado
09-09-2003	09-09-2003	Ingreso en Dresdner Bank	-150000			Luis Bárcenas	confirmado
09-09-2003	09-09-2003	Ingreso en Ingreso en Lombard Odier	-80000			Luis Bárcenas	confirmado
03-10-2003	03-10-2003	Ingreso en Dresdner Bank	-240000			Luis Bárcenas	confirmado
28-11-2003	28-11-2003	Ingreso en Dresdner Bank	-180000			Luis Bárcenas	confirmado
05-12-2003	05-12-2003	Ingreso en Ingreso en Lombard Odier	-300000			Luis Bárcenas	confirmado
19-12-2003	19-12-2003	Ingreso en Dresdner Bank	-162000			Luis Bárcenas	confirmado
05-01-2004	05-01-2004	Ingreso en Dresdner Bank	-180000			Luis Bárcenas	confirmado
23-01-2004	23-01-2004	Ingreso en Ingreso en Lombard Odier	-91000			Luis Bárcenas	confirmado
23-01-2004	23-01-2004	Ingreso en Ingreso en Lombard Odier	-240000			Luis Bárcenas	confirmado
20-02-2004	20-02-2004	Ingreso en Ingreso en Lombard Odier	-45000			Luis Bárcenas	confirmado
09-03-2004	09-03-2004	Ingreso en Ingreso en Lombard Odier	-3000			Luis Bárcenas	confirmado
10-04-2004	10-04-2004	Ingreso en Dresdner Bank	-150000			Luis Bárcenas	confirmado
23-04-2004	23-04-2004	Ingreso en Ingreso en Lombard Odier	-200000			Luis Bárcenas	confirmado
02-07-2004	02-07-2004	Ingreso en Dresdner Bank	-192000			Luis Bárcenas	confirmado
17-09-2004	17-09-2004	Ingreso en Ingreso en Lombard Odier	-200000			Luis Bárcenas	confirmado
12-10-2004	12-10-2004	Ingreso en Dresdner Bank	-150000			Luis Bárcenas	confirmado
01-11-2004	01-11-2004	Ingreso en Ingreso en Lombard Odier	-200000			Luis Bárcenas	confirmado
04-11-2004	04-11-2004	Ingreso en Ingreso en Lombard Odier	-150000			Luis Bárcenas	confirmado
08-12-2004	08-12-2004	Ingreso en Ingreso en Lombard Odier	-250000			Luis Bárcenas	confirmado
04-01-2005	04-01-2005	Ingreso en Dresdner Bank	-149000			Luis Bárcenas	confirmado
28-01-2005	28-01-2005	Ingreso en Ingreso en Lombard Odier	-200000			Luis Bárcenas	confirmado
05-03-2005	05-03-2005	Ingreso en Dresdner Bank	-200000			Luis Bárcenas	confirmado
15-04-2005	15-04-2005	Ingreso en Ingreso en Lombard Odier	-180000			Luis Bárcenas	confirmado
30-05-2005	30-05-2005	Ingreso en Ingreso en Lombard Odier	-60000			Luis Bárcenas	confirmado
24-06-2005	24-06-2005	Ingreso en Dresdner Bank	-106000			Luis Bárcenas	confirmado
16-08-2005	16-08-2005	Ingreso en Ingreso en Lombard Odier	-59000			Luis Bárcenas	confirmado
06-09-2005	06-09-2005	Ingreso en Ingreso en Lombard Odier	-100000			Luis Bárcenas	confirmado
12-10-2005	12-10-2005	Ingreso en Ingreso en Lombard Odier	-97000			Luis Bárcenas	confirmado
15-11-2005	15-11-2005	Ingreso en Ingreso en Lombard Odier	-100000			Luis Bárcenas	confirmado
08-03-2006	08-03-2006	Ingreso en Ingreso en Lombard Odier	-100000			Luis Bárcenas	confirmado
27-06-2006	27-06-2006	Ingreso en Dresdner Bank	-40000			Luis Bárcenas	confirmado
16-11-2006	16-11-2006	Ingreso en Dresdner Bank	-30000			Luis Bárcenas	confirmado
23-03-2007	23-03-2007	Ingreso en Dresdner Bank	-25000			Luis Bárcenas	confirmado
03-05-2007	03-05-2007	Ingreso en Ingreso en Lombard Odier	-100000			Luis Bárcenas	confirmado
25-05-2007	25-05-2007	Ingreso en Ingreso en Lombard Odier	-50000			Luis Bárcenas	confirmado
13-07-2007	13-07-2007	Ingreso en Ingreso en Lombard Odier	-200000			Luis Bárcenas	confirmado
13-07-2007	13-07-2007	Ingreso en Ingreso en Lombard Odier	-100000			Luis Bárcenas	confirmado
16-07-2007	16-07-2007	Ingreso en Ingreso en Lombard Odier	-100000			Luis Bárcenas	confirmado
12-09-2007	12-09-2007	Ingreso en Ingreso en Lombard Odier	-100000			Luis Bárcenas	confirmado
15-11-2007	15-11-2007	Ingreso en Ingreso en Lombard Odier	-50000			Luis Bárcenas	confirmado
06-01-2008	06-01-2008	Ingreso en Ingreso en Lombard Odier	-50000			Luis Bárcenas	confirmado
29-06-2008	29-06-2008	Ingreso en Ingreso en Lombard Odier	-30000			Luis Bárcenas	confirmado
24-11-2008	24-11-2008	Ingreso en Ingreso en Lombard Odier	-9000			Luis Bárcenas	confirmado
31-06-2007	31-06-2007	Ingreso en Dresdner Bank	-20000			Luis Bárcenas	confirmado
